██████████
█  ┴ ┤ ┐ █
█┌┌ ──  ─█
█   ─  ──█
█│████│███████
█└┬───┴┬─│┘  █
██└┐██┌┘█    █
███│█┌┘██    █
███└┬┘███┌┘└┐█
████└──── ┐  █
██████████████