█████████████████
█╔══════╗████████
█║██████║████████
█║█┌ ┘  ║  ┐    █
█╚  ═╡██║██ ─┌█│█
███   ██║██┌  ─┘█
███ ┐└█┌╨┐█   ─ █
███└ │█  ─███████
███████└ ┘███████
█████████████████