█████████████████
█╔══════╗████████
█║██████║████████
█║█┌ ┘  ║  ┐    █
█╚  ═╡██║██ ─┌█│█
███   ██║██┌  ─┘█
███ ┐└█┌╨┐█  ┘─ █
███└ │█  ─███████
███████└ ┘███████
█████████████████