█████████
█└     ┘█
███ ◊   █
█┌     ┐█
█████████