█████████
█└█    ┘█
███ ◊   █
█┌     ┐█
█████████