███████████
█ │██╷██═ █
█╒══════ ╕█
█└╴██╵██╶┘█
███████████