████████
█  ◊   █
█┌─  ┬┐█
█│ █ │ █
█└  ─┘ █
████████