███████████████████████
█◊         ◊         ◊█
█     ┐     ┌┬─       █
█  ┌─┐       ┼┬       █
█  │ │    ┌┼─┤└┐   ┬  █
█  └─┘    └┴┐└┬┘      █
█    ┘      └┬┘       █
█ ┌┬  ┌─┐  └─┴  ┴     █
█ └┘  │ │             █
█◊    └─┘            ◊█
███████████████████████