█████ █████ █████
█┌  ███╶ ┐███  ┐█
█    █└ ◊ ┘█    █
█   ███│││███   █
██ ██ ██ ██ ██ ██
 ███   █─█   ███
██─██ ██ ██ ██ ██
█┬┌┘███┘ ─███┬ ┐█
█┌◊ ┌ ─ ┘ ┌ │ ◊ █
█  ┘███─ ─███└  █
██ ██ ██ ██ ██┬██
 ███   █─█   ███
██ ██ ██ ██ ██ ██
█   ███│││███┌ ┘█
█ ─└ █├ ◊┐ █ ╵│┘█
█   ███└│┘███ │ █
█████ █████ █████