████████
█  ╷╷  █
█ ╶╆╅╴ █
█ ╶╄ ╴ █
█  ╵╀  █
█   ╵  █
████████